111111111111111111111111
10000P000000000000000001
100000000CC0000000000001
100000000111110000000001
100000001100000000000001
100000000E00000000000001
111111111111111111111111