11111111111111111111111111111111111111
10000000000000000000000000000000000001
10001111011101000101111011110111110001
10001001010001100100101010010010010001
10001001011101010100101010010011110001
10001001010001001100101010010010100001
10001111011101000101111011110010010001
10000000000000000000000000000000000001
10000000000000000000000000000000000001
10001110100101001011110100101001011101
10001000100101001010000100101010010101
10001000111101001011110111101100011101
100010001P0101001000010100101010010101
100011101C0101111011110100101001010101
100000000E0000000000000000000000000001
10000000000000000000000000000000000001
10000000000000000000000000000000000001
11111111111111111111111111111111111111
